11111111
10000001
10000001
10001N01
10000001
10000001
11111111
