NO ./texture/bluestone.png
SO ./texture/colorstone.png
WE ./texture/greystone.png
EA ./texture/mossy.png

F 220,100,0
C 225,30,0



11111 11111111
10001110000001
11100000100W01
11111111111101
           101
           101
           111
