1111  1111111
00001110000001
11100000100W01
11111111111101
           101
           101
           111
