11111111111
10000000001
100000000N0
11111111111
