11111
10001
10001
1a111
11111
